#############################                              ...............................
###################                                      .................................
##########                                              ..................................
##########                                              ..................................
###########                                              .................................
#############                                                            .................
########                ^^^^^^                                        ....................
###########               ^^                                        ......................
#########                                                                  ...............
########                              *******                    .........................
##############                      *************                    .....................
########                               ****                    ...........................
#####                                                            .........................
#                                                            .............................
#        ..........................  .....................................................
      .............................  .....................................................
...................................  .....................................................
...................................  .....................................................
...............................                ....................................       
.........................                          .............................          
